20 20
### ################
### ##      #    ###
### ## #### # ##  ##
### #  ###  # ### ##
### # ##   ##   # ##
### # ## ###### # ##
### # ##  ##### # ##
##  # ### ##### # ##
## ## # #   ##  # ##
## ## # ###    #  ##
## ## # # ###### ###
## ## #        # ###
## ##    ### ### ###
## ## ## ##  ### ###
## ## #  ###   # ###
##    # ###### # ###
####### #    # # ###
      ### ## ### ###
#####  #  ##  #  ###
######   ####   ####
0 3
17 0